{
    "levels": [
        {
            "cheap": [
                [ 6, 4 ],
                [ 4, 6 ],
                [ 5, 4 ],
                [ 4, 5 ],
                [ 7, 4 ],
                [ 4, 7 ],
                [ 8, 7 ],
                [ 7, 8 ],
                [ 9, 7 ],
                [ 7, 9 ],
                [ 8, 6 ],
                [ 6, 8 ],
                [ 5, 2 ],
                [ 2, 5 ],
                [ 5, 1 ],
                [ 1, 5 ],
                [ 6, 2 ],
                [ 2, 6 ]
            ],
            "expensive": [
                [ 6, 1 ],
                [ 1, 6 ],
                [ 6, 0 ],
                [ 0, 6 ],
                [ 11, 8 ],
                [ 8, 11 ],
                [ 10, 8 ],
                [ 8, 10 ]
            ]
        },
        {
            "cheap": [
                [ 6, 3 ],
                [ 3, 6 ],
                [ 6, 2 ],
                [ 2, 6 ],
                [ 7, 3 ],
                [ 3, 7 ],
                [ 11, 7 ],
                [ 7, 11 ],
                [ 11, 8 ],
                [ 8, 11 ],
                [ 10, 7 ],
                [ 7, 10 ],
                [ 6, 1 ],
                [ 1, 6 ],
                [ 5, 1 ],
                [ 1, 5 ],
                [ 7, 1 ],
                [ 1, 7 ]
            ],
            "expensive": [
                [ 4, 3 ],
                [ 3, 4 ],
                [ 4, 2 ],
                [ 2, 4 ],
                [ 9, 7 ],
                [ 7, 9 ],
                [ 9, 6 ],
                [ 6, 9 ]
            ]
        },
        {
            "cheap": [
                [ 5, 3 ],
                [ 3, 5 ],
                [ 4, 3 ],
                [ 3, 4 ],
                [ 5, 4 ],
                [ 4, 5 ],
                [ 8, 5 ],
                [ 5, 8 ],
                [ 8, 6 ],
                [ 6, 8 ],
                [ 8, 4 ],
                [ 4, 8 ],
                [ 3, 1 ],
                [ 1, 3 ],
                [ 3, 0 ],
                [ 0, 3 ],
                [ 2, 1 ],
                [ 1, 2 ]
            ],
            "expensive": [
                [ 6, 4 ],
                [ 4, 6 ],
                [ 7, 4 ],
                [ 4, 7 ],
                [ 9, 6 ],
                [ 6, 9 ],
                [ 9, 5 ],
                [ 5, 9 ]
            ]
        }
    ]
}